#########################################
#...#.......#.........#.........#...#   #
###.#.#####.#.#######.#.#######.#.#.### #
#...#.#.....#...#...#.#...#   #...#...# #
#.###.#.##### #.#.#.#.###.# #########.# #
#.....#...#   #.#.#...#...#         #.# #
#########.#####.#.#####.### ####### #.# #
#.......#.......#.#    .# # #   #   #.# #
#.#####.#########.#####.# # # ### ###.# #
#...# #...........#.....#   #   #   #.# #
###.# #############.##### ### # ### #.# #
#...#    .........#.#       # #   # #.# #
#.#######.#######.#.####### ### # # #.# #
#...#.....#   #...#.......#   # # # #...#
###.#.##### ###.#########.### ### # ###.#
# #.#.....#.....#.......#.# #   # # #...#
# #.#####.#.#####.#####.#.# ### # # #.###
# #...#...#...#  .#   #...#     # # #.# #
# ###.#.#####.###.# ####### ##### # #.# #
#    ...#    .....#               #  ...#
#########################################
