#####################
#.#      ...#       #
#.#######.#.##### ###
#.........#.#...#   #
###########.#.#.### #
#         #.#.#.#   #
# ##### # #.#.#.# ###
#   # # # #...#.#   #
### # # #######.### #
#     #        .....#
#####################
