#####
#.# #
#.# #
#...#
#####
